GOOGLE ADS KEYWORD AUDIT REPORT
========================================================================================================================

CRITICAL ISSUE: Keywords exceeding 35-character limit

Total ad groups analyzed: 1230
Invalid keywords (>35 chars): 317
Valid keywords (≤35 chars): 913
Percentage invalid: 25.8%

INVALID KEYWORDS (sorted by length):
------------------------------------------------------------------------------------------------------------------------
City                                     | Keyword                                                      | Length
------------------------------------------------------------------------------------------------------------------------
List of built-up areas in Wales by population | [man with a van near me] list of built-up areas in wales by population | 70 chars (OVER by 35)
"From Wikipedia, the free encyclopedia"  | [man with a van near me] "from wikipedia, the free encyclopedia" | 64 chars (OVER by 29)
List of standardised Welsh place-names   | [man with a van near me] list of standardised welsh place-names | 63 chars (OVER by 28)
Map of some cities and towns in Wales.   | [man with a van near me] map of some cities and towns in wales. | 63 chars (OVER by 28)
Welsh place names in other countries     | [man with a van near me] welsh place names in other countries | 61 chars (OVER by 26)
Bletchley and Fenny Stratford            | [man with a van near me] bletchley and fenny stratford       | 54 chars (OVER by 19)
TopABCDEFGHIJKLMNOPQRSTUVWXYZ            | [man with a van near me] topabcdefghijklmnopqrstuvwxyz       | 54 chars (OVER by 19)
South Kirkby and Moorthorpe              | [man with a van near me] south kirkby and moorthorpe         | 52 chars (OVER by 17)
Broadstairs and St Peter's               | [man with a van near me] broadstairs and st peter's          | 51 chars (OVER by 16)
Northleach with Eastington               | [man with a van near me] northleach with eastington          | 51 chars (OVER by 16)
Swanscombe and Greenhithe                | [man with a van near me] swanscombe and greenhithe           | 50 chars (OVER by 15)
"Newport, Pembrokeshire"                 | [man with a van near me] "newport, pembrokeshire"            | 49 chars (OVER by 14)
Elstree and Borehamwood                  | [man with a van near me] elstree and borehamwood             | 48 chars (OVER by 13)
List of cities in Wales                  | [man with a van near me] list of cities in wales             | 48 chars (OVER by 13)
List of towns in Europe                  | [man with a van near me] list of towns in europe             | 48 chars (OVER by 13)
Queenborough-in-Sheppey                  | [man with a van near me] queenborough-in-sheppey             | 48 chars (OVER by 13)
Wolverton and Greenleys                  | [man with a van near me] wolverton and greenleys             | 48 chars (OVER by 13)
Appleby-in-Westmorland                   | [man with a van near me] appleby-in-westmorland              | 47 chars (OVER by 12)
Letchworth Garden City                   | [man with a van near me] letchworth garden city              | 47 chars (OVER by 12)
List of towns in Wales                   | [man with a van near me] list of towns in wales              | 47 chars (OVER by 12)
Mablethorpe and Sutton                   | [man with a van near me] mablethorpe and sutton              | 47 chars (OVER by 12)
See alsoExternal links                   | [man with a van near me] see alsoexternal links              | 47 chars (OVER by 12)
Blackwater and Hawley                    | [man with a van near me] blackwater and hawley               | 46 chars (OVER by 11)
Harworth and Bircotes                    | [man with a van near me] harworth and bircotes               | 46 chars (OVER by 11)
Ollerton and Boughton                    | [man with a van near me] ollerton and boughton               | 46 chars (OVER by 11)
Royal Tunbridge Wells                    | [man with a van near me] royal tunbridge wells               | 46 chars (OVER by 11)
Royal Wootton Bassett                    | [man with a van near me] royal wootton bassett               | 46 chars (OVER by 11)
South Woodham Ferrers                    | [man with a van near me] south woodham ferrers               | 46 chars (OVER by 11)
Broughton-in-Furness                     | [man with a van near me] broughton-in-furness                | 45 chars (OVER by 10)
Dinnington St John's                     | [man with a van near me] dinnington st john's                | 45 chars (OVER by 10)
Kingston-upon-Thames                     | [man with a van near me] kingston-upon-thames                | 45 chars (OVER by 10)
Newbiggin-by-the-Sea                     | [man with a van near me] newbiggin-by-the-sea                | 45 chars (OVER by 10)
Newcastle-under-Lyme                     | [man with a van near me] newcastle-under-lyme                | 45 chars (OVER by 10)
Royal Leamington Spa                     | [man with a van near me] royal leamington spa                | 45 chars (OVER by 10)
Skelton-in-Cleveland                     | [man with a van near me] skelton-in-cleveland                | 45 chars (OVER by 10)
Wainfleet All Saints                     | [man with a van near me] wainfleet all saints                | 45 chars (OVER by 10)
Llanfair Caereinion                      | [man with a van near me] llanfair caereinion                 | 44 chars (OVER by 9)
Saltburn-By-The-Sea                      | [man with a van near me] saltburn-by-the-sea                 | 44 chars (OVER by 9)
Staines-upon-Thames                      | [man with a van near me] staines-upon-thames                 | 44 chars (OVER by 9)
Stourport-on-Severn                      | [man with a van near me] stourport-on-severn                 | 44 chars (OVER by 9)
Stratford-upon-Avon                      | [man with a van near me] stratford-upon-avon                 | 44 chars (OVER by 9)
Abingdon-on-Thames                       | [man with a van near me] abingdon-on-thames                  | 43 chars (OVER by 8)
Barton-upon-Humber                       | [man with a van near me] barton-upon-humber                  | 43 chars (OVER by 8)
Berwick-upon-Tweed                       | [man with a van near me] berwick-upon-tweed                  | 43 chars (OVER by 8)
Bishop's Stortford                       | [man with a van near me] bishop's stortford                  | 43 chars (OVER by 8)
Blaenau Ffestiniog                       | [man with a van near me] blaenau ffestiniog                  | 43 chars (OVER by 8)
Budleigh Salterton                       | [man with a van near me] budleigh salterton                  | 43 chars (OVER by 8)
Chapel-en-le-Frith                       | [man with a van near me] chapel-en-le-frith                  | 43 chars (OVER by 8)
Frinton and Walton                       | [man with a van near me] frinton and walton                  | 43 chars (OVER by 8)
Geography of Wales                       | [man with a van near me] geography of wales                  | 43 chars (OVER by 8)
Kirkby-in-Ashfield                       | [man with a van near me] kirkby-in-ashfield                  | 43 chars (OVER by 8)
Llandudno Junction                       | [man with a van near me] llandudno junction                  | 43 chars (OVER by 8)
Medlar-with-Wesham                       | [man with a van near me] medlar-with-wesham                  | 43 chars (OVER by 8)
Poynton-with-Worth                       | [man with a van near me] poynton-with-worth                  | 43 chars (OVER by 8)
Princes Risborough                       | [man with a van near me] princes risborough                  | 43 chars (OVER by 8)
St Just-in-Penwith                       | [man with a van near me] st just-in-penwith                  | 43 chars (OVER by 8)
Sturminster Newton                       | [man with a van near me] sturminster newton                  | 43 chars (OVER by 8)
Wells-next-the-Sea                       | [man with a van near me] wells-next-the-sea                  | 43 chars (OVER by 8)
Welwyn Garden City                       | [man with a van near me] welwyn garden city                  | 43 chars (OVER by 8)
Ashby-de-la-Zouch                        | [man with a van near me] ashby-de-la-zouch                   | 42 chars (OVER by 7)
Ashton-under-Lyne                        | [man with a van near me] ashton-under-lyne                   | 42 chars (OVER by 7)
Barrow-in-Furness                        | [man with a van near me] barrow-in-furness                   | 42 chars (OVER by 7)
Burnham-on-Crouch                        | [man with a van near me] burnham-on-crouch                   | 42 chars (OVER by 7)
Burton upon Trent                        | [man with a van near me] burton upon trent                   | 42 chars (OVER by 7)
Chester-le-Street                        | [man with a van near me] chester-le-street                   | 42 chars (OVER by 7)
Cleobury Mortimer                        | [man with a van near me] cleobury mortimer                   | 42 chars (OVER by 7)
Contact Wikipedia                        | [man with a van near me] contact wikipedia                   | 42 chars (OVER by 7)
Dalton-in-Furness                        | [man with a van near me] dalton-in-furness                   | 42 chars (OVER by 7)
Grange-over-Sands                        | [man with a van near me] grange-over-sands                   | 42 chars (OVER by 7)
Heanor and Loscoe                        | [man with a van near me] heanor and loscoe                   | 42 chars (OVER by 7)
Kirton-in-Lindsey                        | [man with a van near me] kirton-in-lindsey                   | 42 chars (OVER by 7)
Leighton-Linslade                        | [man with a van near me] leighton-linslade                   | 42 chars (OVER by 7)
Llandrindod Wells                        | [man with a van near me] llandrindod wells                   | 42 chars (OVER by 7)
Market Harborough                        | [man with a van near me] market harborough                   | 42 chars (OVER by 7)
Newton-le-Willows                        | [man with a van near me] newton-le-willows                   | 42 chars (OVER by 7)
Norton-on-Derwent                        | [man with a van near me] norton-on-derwent                   | 42 chars (OVER by 7)
Shipston-on-Stour                        | [man with a van near me] shipston-on-stour                   | 42 chars (OVER by 7)
Snaith and Cowick                        | [man with a van near me] snaith and cowick                   | 42 chars (OVER by 7)
Upton-upon-Severn                        | [man with a van near me] upton-upon-severn                   | 42 chars (OVER by 7)
Weston-super-Mare                        | [man with a van near me] weston-super-mare                   | 42 chars (OVER by 7)
Wotton-under-Edge                        | [man with a van near me] wotton-under-edge                   | 42 chars (OVER by 7)
Bishop's Waltham                         | [man with a van near me] bishop's waltham                    | 41 chars (OVER by 6)
Bradford-on-Avon                         | [man with a van near me] bradford-on-avon                    | 41 chars (OVER by 6)
Carlton Colville                         | [man with a van near me] carlton colville                    | 41 chars (OVER by 6)
Chipping Campden                         | [man with a van near me] chipping campden                    | 41 chars (OVER by 6)
Chipping Sodbury                         | [man with a van near me] chipping sodbury                    | 41 chars (OVER by 6)
Cookie statement                         | [man with a van near me] cookie statement                    | 41 chars (OVER by 6)
Gorleston-on-Sea                         | [man with a van near me] gorleston-on-sea                    | 41 chars (OVER by 6)
Great Torrington                         | [man with a van near me] great torrington                    | 41 chars (OVER by 6)
Henley-on-Thames                         | [man with a van near me] henley-on-thames                    | 41 chars (OVER by 6)
Moreton-in-Marsh                         | [man with a van near me] moreton-in-marsh                    | 41 chars (OVER by 6)
Moretonhampstead                         | [man with a van near me] moretonhampstead                    | 41 chars (OVER by 6)
Penrhyndeudraeth                         | [man with a van near me] penrhyndeudraeth                    | 41 chars (OVER by 6)
Stockton-on-Tees                         | [man with a van near me] stockton-on-tees                    | 41 chars (OVER by 6)
Stoke-upon-Trent                         | [man with a van near me] stoke-upon-trent                    | 41 chars (OVER by 6)
Stow-on-the-Wold                         | [man with a van near me] stow-on-the-wold                    | 41 chars (OVER by 6)
Sutton Coldfield                         | [man with a van near me] sutton coldfield                    | 41 chars (OVER by 6)
Thornaby-on-Tees                         | [man with a van near me] thornaby-on-tees                    | 41 chars (OVER by 6)
Thorpe St Andrew                         | [man with a van near me] thorpe st andrew                    | 41 chars (OVER by 6)
Totton and Eling                         | [man with a van near me] totton and eling                    | 41 chars (OVER by 6)
Walton-on-Thames                         | [man with a van near me] walton-on-thames                    | 41 chars (OVER by 6)
Wath-upon-Dearne                         | [man with a van near me] wath-upon-dearne                    | 41 chars (OVER by 6)
Wimborne Minster                         | [man with a van near me] wimborne minster                    | 41 chars (OVER by 6)
About Wikipedia                          | [man with a van near me] about wikipedia                     | 40 chars (OVER by 5)
Appearance hide                          | [man with a van near me] appearance hide                     | 40 chars (OVER by 5)
Bishop Auckland                          | [man with a van near me] bishop auckland                     | 40 chars (OVER by 5)
Bishop's Castle                          | [man with a van near me] bishop's castle                     | 40 chars (OVER by 5)
Blandford Forum                          | [man with a van near me] blandford forum                     | 40 chars (OVER by 5)
Braunstone Town                          | [man with a van near me] braunstone town                     | 40 chars (OVER by 5)
Bury St Edmunds                          | [man with a van near me] bury st edmunds                     | 40 chars (OVER by 5)
Chipping Norton                          | [man with a van near me] chipping norton                     | 40 chars (OVER by 5)
Church Stretton                          | [man with a van near me] church stretton                     | 40 chars (OVER by 5)
Code of Conduct                          | [man with a van near me] code of conduct                     | 40 chars (OVER by 5)
Epsom and Ewell                          | [man with a van near me] epsom and ewell                     | 40 chars (OVER by 5)
Greater Glasgow                          | [man with a van near me] greater glasgow                     | 40 chars (OVER by 5)
Hemel Hempstead                          | [man with a van near me] hemel hempstead                     | 40 chars (OVER by 5)
Henley-in-Arden                          | [man with a van near me] henley-in-arden                     | 40 chars (OVER by 5)
Ingleby Barwick                          | [man with a van near me] ingleby barwick                     | 40 chars (OVER by 5)
Irthlingborough                          | [man with a van near me] irthlingborough                     | 40 chars (OVER by 5)
Jump to content                          | [man with a van near me] jump to content                     | 40 chars (OVER by 5)
Kirkby Lonsdale                          | [man with a van near me] kirkby lonsdale                     | 40 chars (OVER by 5)
Llanwrtyd Wells                          | [man with a van near me] llanwrtyd wells                     | 40 chars (OVER by 5)
Lytham St Annes                          | [man with a van near me] lytham st annes                     | 40 chars (OVER by 5)
Market Bosworth                          | [man with a van near me] market bosworth                     | 40 chars (OVER by 5)
Market Weighton                          | [man with a van near me] market weighton                     | 40 chars (OVER by 5)
Midsomer Norton                          | [man with a van near me] midsomer norton                     | 40 chars (OVER by 5)
Newark-on-Trent                          | [man with a van near me] newark-on-trent                     | 40 chars (OVER by 5)
Newcastle Emlyn                          | [man with a van near me] newcastle emlyn                     | 40 chars (OVER by 5)
Newport Pagnell                          | [man with a van near me] newport pagnell                     | 40 chars (OVER by 5)
Newton Aycliffe                          | [man with a van near me] newton aycliffe                     | 40 chars (OVER by 5)
North Petherton                          | [man with a van near me] north petherton                     | 40 chars (OVER by 5)
Shoreham-by-Sea                          | [man with a van near me] shoreham-by-sea                     | 40 chars (OVER by 5)
St Columb Major                          | [man with a van near me] st columb major                     | 40 chars (OVER by 5)
Stony Stratford                          | [man with a van near me] stony stratford                     | 40 chars (OVER by 5)
WalesÂ articles                          | [man with a van near me] walesâ articles                     | 40 chars (OVER by 5)
Barnard Castle                           | [man with a van near me] barnard castle                      | 39 chars (OVER by 4)
Bexhill-on-Sea                           | [man with a van near me] bexhill-on-sea                      | 39 chars (OVER by 4)
Burgh-le-Marsh                           | [man with a van near me] burgh-le-marsh                      | 39 chars (OVER by 4)
Burnham-on-Sea                           | [man with a van near me] burnham-on-sea                      | 39 chars (OVER by 4)
Burton Latimer                           | [man with a van near me] burton latimer                      | 39 chars (OVER by 4)
Create account                           | [man with a van near me] create account                      | 39 chars (OVER by 4)
Downham Market                           | [man with a van near me] downham market                      | 39 chars (OVER by 4)
East Grinstead                           | [man with a van near me] east grinstead                      | 39 chars (OVER by 4)
Ellesmere Port                           | [man with a van near me] ellesmere port                      | 39 chars (OVER by 4)
Great Yarmouth                           | [man with a van near me] great yarmouth                      | 39 chars (OVER by 4)
Haywards Heath                           | [man with a van near me] haywards heath                      | 39 chars (OVER by 4)
Higham Ferrers                           | [man with a van near me] higham ferrers                      | 39 chars (OVER by 4)
Houghton Regis                           | [man with a van near me] houghton regis                      | 39 chars (OVER by 4)
Kirkby Stephen                           | [man with a van near me] kirkby stephen                      | 39 chars (OVER by 4)
Kirkbymoorside                           | [man with a van near me] kirkbymoorside                      | 39 chars (OVER by 4)
Llanfairfechan                           | [man with a van near me] llanfairfechan                      | 39 chars (OVER by 4)
Llantwit Major                           | [man with a van near me] llantwit major                      | 39 chars (OVER by 4)
Market Deeping                           | [man with a van near me] market deeping                      | 39 chars (OVER by 4)
Market Drayton                           | [man with a van near me] market drayton                      | 39 chars (OVER by 4)
Melton Mowbray                           | [man with a van near me] melton mowbray                      | 39 chars (OVER by 4)
Merthyr Tydfil                           | [man with a van near me] merthyr tydfil                      | 39 chars (OVER by 4)
Minchinhampton                           | [man with a van near me] minchinhampton                      | 39 chars (OVER by 4)
Needham Market                           | [man with a van near me] needham market                      | 39 chars (OVER by 4)
Ottery St Mary                           | [man with a van near me] ottery st mary                      | 39 chars (OVER by 4)
Overton-on-Dee                           | [man with a van near me] overton-on-dee                      | 39 chars (OVER by 4)
Pateley Bridge                           | [man with a van near me] pateley bridge                      | 39 chars (OVER by 4)
Privacy policy                           | [man with a van near me] privacy policy                      | 39 chars (OVER by 4)
Saffron Walden                           | [man with a van near me] saffron walden                      | 39 chars (OVER by 4)
Sawbridgeworth                           | [man with a van near me] sawbridgeworth                      | 39 chars (OVER by 4)
Shepton Mallet                           | [man with a van near me] shepton mallet                      | 39 chars (OVER by 4)
Wellingborough                           | [man with a van near me] wellingborough                      | 39 chars (OVER by 4)
Boroughbridge                            | [man with a van near me] boroughbridge                       | 38 chars (OVER by 3)
Bradley Stoke                            | [man with a van near me] bradley stoke                       | 38 chars (OVER by 3)
Brightlingsea                            | [man with a van near me] brightlingsea                       | 38 chars (OVER by 3)
Buckfastleigh                            | [man with a van near me] buckfastleigh                       | 38 chars (OVER by 3)
Bude-Stratton                            | [man with a van near me] bude-stratton                       | 38 chars (OVER by 3)
Canvey Island                            | [man with a van near me] canvey island                       | 38 chars (OVER by 3)
Connah's Quay                            | [man with a van near me] connah's quay                       | 38 chars (OVER by 3)
Droitwich Spa                            | [man with a van near me] droitwich spa                       | 38 chars (OVER by 3)
East Kilbride                            | [man with a van near me] east kilbride                       | 38 chars (OVER by 3)
Fordingbridge                            | [man with a van near me] fordingbridge                       | 38 chars (OVER by 3)
Godmanchester                            | [man with a van near me] godmanchester                       | 38 chars (OVER by 3)
Haverfordwest                            | [man with a van near me] haverfordwest                       | 38 chars (OVER by 3)
Kidderminster                            | [man with a van near me] kidderminster                       | 38 chars (OVER by 3)
Kingsteignton                            | [man with a van near me] kingsteignton                       | 38 chars (OVER by 3)
Kirkintilloch                            | [man with a van near me] kirkintilloch                       | 38 chars (OVER by 3)
Knaresborough                            | [man with a van near me] knaresborough                       | 38 chars (OVER by 3)
Littlehampton                            | [man with a van near me] littlehampton                       | 38 chars (OVER by 3)
Middlesbrough                            | [man with a van near me] middlesbrough                       | 38 chars (OVER by 3)
Milford Haven                            | [man with a van near me] milford haven                       | 38 chars (OVER by 3)
New Alresford                            | [man with a van near me] new alresford                       | 38 chars (OVER by 3)
Newton Mearns                            | [man with a van near me] newton mearns                       | 38 chars (OVER by 3)
North Hykeham                            | [man with a van near me] north hykeham                       | 38 chars (OVER by 3)
North Walsham                            | [man with a van near me] north walsham                       | 38 chars (OVER by 3)
Northallerton                            | [man with a van near me] northallerton                       | 38 chars (OVER by 3)
Pembroke Dock                            | [man with a van near me] pembroke dock                       | 38 chars (OVER by 3)
Pontarddulais                            | [man with a van near me] pontarddulais                       | 38 chars (OVER by 3)
Sittingbourne                            | [man with a van near me] sittingbourne                       | 38 chars (OVER by 3)
South Elmsall                            | [man with a van near me] south elmsall                       | 38 chars (OVER by 3)
South Shields                            | [man with a van near me] south shields                       | 38 chars (OVER by 3)
Tenbury Wells                            | [man with a van near me] tenbury wells                       | 38 chars (OVER by 3)
Vale of Leven                            | [man with a van near me] vale of leven                       | 38 chars (OVER by 3)
Waltham Abbey                            | [man with a van near me] waltham abbey                       | 38 chars (OVER by 3)
Waltham Cross                            | [man with a van near me] waltham cross                       | 38 chars (OVER by 3)
West Bromwich                            | [man with a van near me] west bromwich                       | 38 chars (OVER by 3)
Whaley Bridge                            | [man with a van near me] whaley bridge                       | 38 chars (OVER by 3)
Ystrad Mynach                            | [man with a van near me] ystrad mynach                       | 38 chars (OVER by 3)
Ystradgynlais                            | [man with a van near me] ystradgynlais                       | 38 chars (OVER by 3)
Attleborough                             | [man with a van near me] attleborough                        | 37 chars (OVER by 2)
Barnoldswick                             | [man with a van near me] barnoldswick                        | 37 chars (OVER by 2)
Beaconsfield                             | [man with a van near me] beaconsfield                        | 37 chars (OVER by 2)
Bishopbriggs                             | [man with a van near me] bishopbriggs                        | 37 chars (OVER by 2)
Bognor Regis                             | [man with a van near me] bognor regis                        | 37 chars (OVER by 2)
Bovey Tracey                             | [man with a van near me] bovey tracey                        | 37 chars (OVER by 2)
Briton Ferry                             | [man with a van near me] briton ferry                        | 37 chars (OVER by 2)
Builth Wells                             | [man with a van near me] builth wells                        | 37 chars (OVER by 2)
Burgess Hill                             | [man with a van near me] burgess hill                        | 37 chars (OVER by 2)
Chesterfield                             | [man with a van near me] chesterfield                        | 37 chars (OVER by 2)
Christchurch                             | [man with a van near me] christchurch                        | 37 chars (OVER by 2)
Cleator Moor                             | [man with a van near me] cleator moor                        | 37 chars (OVER by 2)
Earl Shilton                             | [man with a van near me] earl shilton                        | 37 chars (OVER by 2)
East Retford                             | [man with a van near me] east retford                        | 37 chars (OVER by 2)
Featherstone                             | [man with a van near me] featherstone                        | 37 chars (OVER by 2)
Gainsborough                             | [man with a van near me] gainsborough                        | 37 chars (OVER by 2)
Great Dunmow                             | [man with a van near me] great dunmow                        | 37 chars (OVER by 2)
High Wycombe                             | [man with a van near me] high wycombe                        | 37 chars (OVER by 2)
Huddersfield                             | [man with a van near me] huddersfield                        | 37 chars (OVER by 2)
Leigh-on-Sea                             | [man with a van near me] leigh-on-sea                        | 37 chars (OVER by 2)
Loughborough                             | [man with a van near me] loughborough                        | 37 chars (OVER by 2)
Macclesfield                             | [man with a van near me] macclesfield                        | 37 chars (OVER by 2)
Market Rasen                             | [man with a van near me] market rasen                        | 37 chars (OVER by 2)
Menai Bridge                             | [man with a van near me] menai bridge                        | 37 chars (OVER by 2)
Mountain Ash                             | [man with a van near me] mountain ash                        | 37 chars (OVER by 2)
Much Wenlock                             | [man with a van near me] much wenlock                        | 37 chars (OVER by 2)
New Tredegar                             | [man with a van near me] new tredegar                        | 37 chars (OVER by 2)
Newton Abbot                             | [man with a van near me] newton abbot                        | 37 chars (OVER by 2)
North Tawton                             | [man with a van near me] north tawton                        | 37 chars (OVER by 2)
Paddock Wood                             | [man with a van near me] paddock wood                        | 37 chars (OVER by 2)
Rowley Regis                             | [man with a van near me] rowley regis                        | 37 chars (OVER by 2)
Skelmersdale                             | [man with a van near me] skelmersdale                        | 37 chars (OVER by 2)
South Molton                             | [man with a van near me] south molton                        | 37 chars (OVER by 2)
Southborough                             | [man with a van near me] southborough                        | 37 chars (OVER by 2)
Southminster                             | [man with a van near me] southminster                        | 37 chars (OVER by 2)
St Mary Cray                             | [man with a van near me] st mary cray                        | 37 chars (OVER by 2)
Stocksbridge                             | [man with a van near me] stocksbridge                        | 37 chars (OVER by 2)
Talbot Green                             | [man with a van near me] talbot green                        | 37 chars (OVER by 2)
View history                             | [man with a van near me] view history                        | 37 chars (OVER by 2)
West Malling                             | [man with a van near me] west malling                        | 37 chars (OVER by 2)
West Tilbury                             | [man with a van near me] west tilbury                        | 37 chars (OVER by 2)
Westhoughton                             | [man with a van near me] westhoughton                        | 37 chars (OVER by 2)
Wiveliscombe                             | [man with a van near me] wiveliscombe                        | 37 chars (OVER by 2)
Woburn Sands                             | [man with a van near me] woburn sands                        | 37 chars (OVER by 2)
Aberbargoed                              | [man with a van near me] aberbargoed                         | 36 chars (OVER by 1)
Abergavenny                              | [man with a van near me] abergavenny                         | 36 chars (OVER by 1)
Abertillery                              | [man with a van near me] abertillery                         | 36 chars (OVER by 1)
Aberystwyth                              | [man with a van near me] aberystwyth                         | 36 chars (OVER by 1)
Basingstoke                              | [man with a van near me] basingstoke                         | 36 chars (OVER by 1)
Berkhamsted                              | [man with a van near me] berkhamsted                         | 36 chars (OVER by 1)
Biggleswade                              | [man with a van near me] biggleswade                         | 36 chars (OVER by 1)
Bournemouth                              | [man with a van near me] bournemouth                         | 36 chars (OVER by 1)
Bridlington                              | [man with a van near me] bridlington                         | 36 chars (OVER by 1)
Bromborough                              | [man with a van near me] bromborough                         | 36 chars (OVER by 1)
Buntingford                              | [man with a van near me] buntingford                         | 36 chars (OVER by 1)
Castle Cary                              | [man with a van near me] castle cary                         | 36 chars (OVER by 1)
Chorleywood                              | [man with a van near me] chorleywood                         | 36 chars (OVER by 1)
Cirencester                              | [man with a van near me] cirencester                         | 36 chars (OVER by 1)
Cleckheaton                              | [man with a van near me] cleckheaton                         | 36 chars (OVER by 1)
Cleethorpes                              | [man with a van near me] cleethorpes                         | 36 chars (OVER by 1)
Cockermouth                              | [man with a van near me] cockermouth                         | 36 chars (OVER by 1)
Conisbrough                              | [man with a van near me] conisbrough                         | 36 chars (OVER by 1)
Cowdenbeath                              | [man with a van near me] cowdenbeath                         | 36 chars (OVER by 1)
Cramlington                              | [man with a van near me] cramlington                         | 36 chars (OVER by 1)
Craven Arms                              | [man with a van near me] craven arms                         | 36 chars (OVER by 1)
Crickhowell                              | [man with a van near me] crickhowell                         | 36 chars (OVER by 1)
Crowborough                              | [man with a van near me] crowborough                         | 36 chars (OVER by 1)
Cumbernauld                              | [man with a van near me] cumbernauld                         | 36 chars (OVER by 1)
Darley Dale                              | [man with a van near me] darley dale                         | 36 chars (OVER by 1)
Disclaimers                              | [man with a van near me] disclaimers                         | 36 chars (OVER by 1)
Dunfermline                              | [man with a van near me] dunfermline                         | 36 chars (OVER by 1)
Farnborough                              | [man with a van near me] farnborough                         | 36 chars (OVER by 1)
Framlingham                              | [man with a van near me] framlingham                         | 36 chars (OVER by 1)
Glastonbury                              | [man with a van near me] glastonbury                         | 36 chars (OVER by 1)
Grangemouth                              | [man with a van near me] grangemouth                         | 36 chars (OVER by 1)
Grassington                              | [man with a van near me] grassington                         | 36 chars (OVER by 1)
Guisborough                              | [man with a van near me] guisborough                         | 36 chars (OVER by 1)
Haltwhistle                              | [man with a van near me] haltwhistle                         | 36 chars (OVER by 1)
Hatherleigh                              | [man with a van near me] hatherleigh                         | 36 chars (OVER by 1)
Hebden Royd                              | [man with a van near me] hebden royd                         | 36 chars (OVER by 1)
Helensburgh                              | [man with a van near me] helensburgh                         | 36 chars (OVER by 1)
King's Lynn                              | [man with a van near me] king's lynn                         | 36 chars (OVER by 1)
Kingsbridge                              | [man with a van near me] kingsbridge                         | 36 chars (OVER by 1)
Leatherhead                              | [man with a van near me] leatherhead                         | 36 chars (OVER by 1)
Llantrisant                              | [man with a van near me] llantrisant                         | 36 chars (OVER by 1)
Llanybydder                              | [man with a van near me] llanybydder                         | 36 chars (OVER by 1)
Long Sutton                              | [man with a van near me] long sutton                         | 36 chars (OVER by 1)
Lostwithiel                              | [man with a van near me] lostwithiel                         | 36 chars (OVER by 1)
Ludgershall                              | [man with a van near me] ludgershall                         | 36 chars (OVER by 1)
Lutterworth                              | [man with a van near me] lutterworth                         | 36 chars (OVER by 1)
Machynlleth                              | [man with a van near me] machynlleth                         | 36 chars (OVER by 1)
Manningtree                              | [man with a van near me] manningtree                         | 36 chars (OVER by 1)
Marlborough                              | [man with a van near me] marlborough                         | 36 chars (OVER by 1)
Mitcheldean                              | [man with a van near me] mitcheldean                         | 36 chars (OVER by 1)
Mobile view                              | [man with a van near me] mobile view                         | 36 chars (OVER by 1)
Musselburgh                              | [man with a van near me] musselburgh                         | 36 chars (OVER by 1)
Northampton                              | [man with a van near me] northampton                         | 36 chars (OVER by 1)
Penmaenmawr                              | [man with a van near me] penmaenmawr                         | 36 chars (OVER by 1)
Penrhyn Bay                              | [man with a van near me] penrhyn bay                         | 36 chars (OVER by 1)
Petersfield                              | [man with a van near me] petersfield                         | 36 chars (OVER by 1)
Pocklington                              | [man with a van near me] pocklington                         | 36 chars (OVER by 1)
Port Talbot                              | [man with a van near me] port talbot                         | 36 chars (OVER by 1)
Queensferry                              | [man with a van near me] queensferry                         | 36 chars (OVER by 1)
Rawtenstall                              | [man with a van near me] rawtenstall                         | 36 chars (OVER by 1)
Ross-on-Wye                              | [man with a van near me] ross-on-wye                         | 36 chars (OVER by 1)
Scarborough                              | [man with a van near me] scarborough                         | 36 chars (OVER by 1)
Shaftesbury                              | [man with a van near me] shaftesbury                         | 36 chars (OVER by 1)
South Brent                              | [man with a van near me] south brent                         | 36 chars (OVER by 1)
Stalybridge                              | [man with a van near me] stalybridge                         | 36 chars (OVER by 1)
Stourbridge                              | [man with a van near me] stourbridge                         | 36 chars (OVER by 1)
Swadlincote                              | [man with a van near me] swadlincote                         | 36 chars (OVER by 1)
Wallingford                              | [man with a van near me] wallingford                         | 36 chars (OVER by 1)
Walthamstow                              | [man with a van near me] walthamstow                         | 36 chars (OVER by 1)
West Mersea                              | [man with a van near me] west mersea                         | 36 chars (OVER by 1)
